redcap	test
wais_ver	wais
fsiq	wais
vci	wais
sim_raw	wais
sim_ss	wais
voc_raw	wais
voc_ss	wais
in_raw	wais
in_ss	wais
pri	wais
bd_raw	wais
bd_ss	wais
mr_raw	wais
mr_ss	wais
vp_raw	wais
vp_ss	wais
wmi	wais
dsp_raw	wais
dsp_ss	wais
dsp_rel	wais
ar_raw	wais
ar_ss	wais
psi	wais
ss_raw	wais
ss_ss	wais
cd_raw	wais
cd_ss	wais
wms_ver	wms
lm_ver	wms
lmi_raw	wms
lmi_ss	wms
lmii_raw	wms
lmii_ss	wms
lmrec_raw	wms
lmrec_per	wms
vpai_raw	wms
vpai_ss	wms
vpaii_raw	wms
vpaii_ss	wms
vparec_raw	wms
vparec_perc	wms
vri_raw	wms
vri_ss	wms
vrii_raw	wms
vrii_ss	wms
vrrec_raw	wms
vrrec_per	wms
vrcopy_raw	wms
vrcopy_perc	wms
spat_span_raw	wms
spat_span_ss	wms
hvlt_form	hvlt
hvlt_tot_raw	hvlt
hvlt_tot_ss	hvlt
hvlt_tot_per	hvlt
hvlt_tot_int	hvlt
hvlt_delay_raw	hvlt
hvlt_delay_ss	hvlt
hvlt_perc_raw	hvlt
hvlt_perc_ss	hvlt
hvlt_disc_raw	hvlt
hvlt_disc_ss	hvlt
hvlt_disc_tp	hvlt
hvlt_disc_fp	hvlt
hvlt_disc_fn	hvlt
hvlt_memprofile	hvlt
hvlt_memprofile_mixedexplained	hvlt
cvlt_form	cvlt
cvlt_tot_raw	cvlt
cvlt_tot_ss	cvlt
cvlt_sdelayfree_raw	cvlt
cvlt_sdelayfree_ss	cvlt
cvlt_sdelaycued_raw	cvlt
cvlt_sdelaycued_ss	cvlt
cvlt_ldelayfree_raw	cvlt
cvlt_ldelayfree_ss	cvlt
cvlt_ldelaycued_raw	cvlt
cvlt_ldelaycued_ss	cvlt
cvlt_recogdisc_raw	cvlt
cvlt_recogdisc_ss	cvlt
cvlt_fcrecog_perc	cvlt
bvmt_form	bvmt
bvmt_tot_raw	bvmt
bvmt_tot_ss	bvmt
bvmt_delay_raw	bvmt
bvmt_delay_ss	bvmt
bvmt_rec_raw	bvmt
bvmt_rec_perc	bvmt
bnt_ver	bnt
bnt_raw	bnt
bnt_ss	bnt
bdae_cim_raw	bdae
bdae_cim_ss	bdae
bdae_rs_raw	bdae
bdae_rn_raw	bdae
bdae_rn_class	bdae
bdae_ct_raw	bdae
bdae_sp_raw	bdae
bdae_praxis_ng_raw	bdae
bdae_praxis_cg_raw	bdae
bdae_praxis_upo_raw	bdae
bdae_praxis_bfrm_raw	bdae
bdae_wc_raw	bdae
wratread_form	wrat
wratread_raw	wrat
wratread_ss	wrat
wjiii_wa_raw	wjiii
wjiii_wa_ss	wjiii
clock_score	clock
clock_time	clock
clock_class	clock
jlo_form	jlo
jlo_raw	jlo
jlo_ss	jlo
sdmt_writ_raw	sdmt
sdmt_writ_ss	sdmt
sdmt_oral_raw	sdmt
sdmt_oral_ss	sdmt
pasat_form	pasat
pasat_3srate_raw	pasat
pasat_3srate_ss	pasat
pasat_2srate_raw	pasat
pasat_2srate_ss	pasat
cpt3_disc_ss	cpt3
cpt3_detect_class	cpt3
cpt3_omis_ss	cpt3
cpt3_omis_class	cpt3
cpt3_comis_ss	cpt3
cpt3_comis_class	cpt3
cpt3_per_ss	cpt3
cpt3_per_class	cpt3
cpt3_hrt_ss	cpt3
cpt3_hrt_class	cpt3
cpt3_hrtsd_ss	cpt3
cpt3_hrtsd_class	cpt3
cpt3_var_ss	cpt3
cpt3_var_class	cpt3
cpt3_hrtbc_ss	cpt3
cpt3_hrtbc_class	cpt3
cpt3_hrtisi_ss	cpt3
cpt3_hrtisi_class	cpt3
trails_ver	trails
trailsa_raw	trails
trailsa_ss	trails
trailsa_err	trails
trailsb_raw	trails
trailsb_ss	trails
trailsb_err	trails
wcst_ver	wcst
wcst_cat_raw	wcst
wcst_cat_perc	wcst
wcst_fms_raw	wcst
wcst_fms_perc	wcst
wcst_err_raw	wcst
wcst_err_ss	wcst
wcst_per_raw	wcst
wcst_per_ss	wcst
letfluency_ver	letterfluency
dkefsletterflue_raw	letterfluency
dkefsletterflue_ss	letterfluency
dkefsletterlfue_per	letterfluency
dkefsleterflue_int	letterfluency
letfluency_raw	letterfluency
letfluency_ss	letterfluency
letfluency_per	letterfluency
letfluency_int	letterfluency
catfluency_ver	letterfluency
dkefscatflu_raw	letterfluency
dkefscatflu_ss	letterfluency
dkefscatflu_per	letterfluency
dkefscatflu_int	letterfluency
catfluency_raw	letterfluency
catfluency_ss	letterfluency
catfluency_per	letterfluency
catfluency_int	letterfluency
dkefs_switch_vers	letterfluency
dkefsswitchfluency_raw	letterfluency
dkefsswitchfluency_ss	letterfluency
dkefsswitchaccuracy_raw	letterfluency
dkefsswitchaccuracy_ss	letterfluency
dkefstrails_vis_scan_raw	letterfluency
dkefstrails_vis_scan_ss	letterfluency
dkefstrails_num_seq_raw	letterfluency
dkefstrails_num_seq_ss	letterfluency
dkefstrails_let_seq_raw	letterfluency
dkefstrails_let_seq_ss	letterfluency
dkefstrails_switch_raw	letterfluency
dkefstrails_switch_ss	letterfluency
dkefstrails_errors_raw	letterfluency
dkefstrails_errors_ss	letterfluency
dkefstrails_mot_speed_raw	letterfluency
dkefstrails_mot_speed_ss	letterfluency
dkefstower_ach_score_raw	letterfluency
dkefstower_ach_score_ss	letterfluency
dkefstower_mean1move_raw	letterfluency
dkefstower_mean1move_ss	letterfluency
dkefstower_timepermove_raw	letterfluency
dkefstower_timepermove_ss	letterfluency
dkefstower_move_acc_raw	letterfluency
dkefstower_move_acc_ss	letterfluency
dkefstower_rule_viol_raw	letterfluency
dkefstower_rule_viol_ss	letterfluency
dkefstower_tot_rvs_raw	letterfluency
dkefstower_tot_rvs_perc	letterfluency
book_cat_errors_raw	book
book_cat_errors_ss	book
pegs_dh_trial1_raw	pegs
pegs_dh_trial1_ss	pegs
pegs_ndh_trial1_raw	pegs
pegs_ndh_trial1_ss	pegs
gripstrength_dh_raw	gripstrength
gripstrength_dh_ss	gripstrength
gripstrength_ndh_raw	gripstrength
gripstrength_ndh_ss	gripstrength
gds_raw	gds
gds_class	gds
bdi_raw	bdi
bdi_class	bdi
depression_label	bdi
adfacs_iadlperc	adfacs
adfacs_adlperc	adfacs
adfacs_tot	adfacs
maq_physio_panic	maq
maq_soc_pho	maq
maq_worry_fear	maq
maq_neg_aff	maq
maq_tot	maq
bai_raw	bai
bai_ss	bai
bai_class	bai
